1111111111111111
1000000000000001
1000000000000001
1000222222220001
1000222222220001
1000220000220000
1000220000220000
1000220000220000
1000222002220001
1000222002220001
1000000000000001
1111111111111111